####################
#000#00000#00000000#
###0#0###000####0#0#
#000###000###0000#0#
#0#00#00#0#00000##0#
#0#####0#000##00000#
#0#0#000#00000#00#0#
#0#0#0#######00###0#
#000000000#00000000#
####################
