############
|0000|00000|
||0###0####|
||00000|000|
||000000000|
|###|0000##|
|0000000000|
|00000###00|
|###000|000|
|00|00#####|
|00|000000||
############